trái cam - orange
trái quýt - Mandarin orange
trái bắp - corn
trái chuối - banana
trái mít - jackfruit
trái đu đủ - papaya
trái sầu riêng - durian
trái mãng cầu - fruit custard
trái nho - grape
trái kiwi - Kiwi fruit
trái sơ ri - acelora
trái sa pô chê - Sapodilla
trái chôm chôm - rambutan
trái cherry - cherry
trái táo - apple
trái dâu tây - Strawberry
trái bưởi - grapefruit
trái mận - plum
trái đào - peaches
trái dừa - coconut
trái xoài - mango
trái vú sữa - star apple
trái nhãn - longan
trái lê ki ma - lucuma
trái dừa nước - nipa palm
trái mãng cầu xiêm - soursop fruit
trái khế - star fruit
trái me - tamarind
trái măng cụt - mangosteen
trái chùm ruột - Star Gooseberry
trái lê - pear
trái vải - lychee
trái ổi - guava
trái thanh long - Dragon fruit
trái bơ - avocado
trái hồng - persimmon
trái dứa - Pineapple
trái dưa hấu - watermelon
trái dưa lưới - Cantaloupe
trái dưa leo - cucumber
trái chanh - lemon
trái tắc - kumquat
trái dâu da - Baccaurea
trái điều - cashew apple
trái sung - Common fig



